{
    "mazes": [
        {
            "size": 8,
            "layouts": [
                [
                    "########",
                    "#      #",
                    "# #### #",
                    "# #  # #",
                    "# # ## #",
                    "#    # #",
                    "# #### #",
                    "########"
                ],
                [
                    "########",
                    "# #    #",
                    "# # ## #",
                    "#    # #",
                    "###### #",
                    "#      #",
                    "# ######",
                    "########"
                ]
            ]
        },
        {
            "size": 10,
            "layouts": [
                [
                    "##########",
                    "#        #",
                    "# ###### #",
                    "# #    # #",
                    "# # ## # #",
                    "# # ## # #",
                    "#      # #",
                    "# ###### #",
                    "#        #",
                    "##########"
                ],
                [
                    "##########",
                    "# #      #",
                    "# # #### #",
                    "#   #  # #",
                    "### ## # #",
                    "#   ## # #",
                    "#      # #",
                    "# ###### #",
                    "#        #",
                    "##########"
                ]
            ]
        },
        {
            "size": 12,
            "layouts": [
                [
                    "############",
                    "#          #",
                    "# ###### # #",
                    "# #    # # #",
                    "# # ## # # #",
                    "# # ## #   #",
                    "# #    #####",
                    "# ######   #",
                    "#        # #",
                    "###### # # #",
                    "#      #   #",
                    "############"
                ],
                [
                    "############",
                    "# #        #",
                    "# # ###### #",
                    "#   #    # #",
                    "##### ## # #",
                    "#     ##   #",
                    "# ####### ##",
                    "# #        #",
                    "# ### ######",
                    "#   #      #",
                    "###### #####",
                    "############"
                ]
            ]
        }
    ]
}